##########
#...##.###
###.##.###
##..r....#
##....##.#
########.#
#..##..l.#
##.##.####
#.l....l.#
##########